XXXXXXXXXXXXXXXX
X4O          O1X
XOXXXX XXXXX XOX
X X    X X     X
X   X    X XXXOX
XOX XXXX X     X
X7X X        X X
XOX XXXXXX XXX X
X          O5XOX
X XXXXXOX  XXX6X
X     O8O    XOX
XOXXX XOXXXX   X
X3O     O9O    X
XOXXX XXXXXX XOX
X            O2X
XXXXXXXXXXXXXXXX